00000000000002
00002000000000
00000000111111
00010000000000
02010000200000
00010010000000
00000010011110
01000000000000
00010200001200
00011110001000
00000000101000
00020001201000
00000001001100
00000000000000