00010000000000
01010000000000
01010100000000
01010100000000
01010100000000
01010100100000
01010100102000
01010100100000
01010100000000
01010100000000
01010100000000
01010100000000
01010000000000
01000000000000